[properties]
name: "test map"
width: 20
height: 16
fog: 0

[terrain]
2 2 2 2 2 2 2 2 2 2 2 2 2 2 2 2 2 2 2 2
2 2 2 2 2 2 2 0 0 0 0 0 0 0 2 2 2 2 2 2
2 2 2 2 2 0 0 2 2 2 2 2 2 0 0 2 2 2 2 2
2 2 2 0 0 0 2 2 2 2 2 2 2 2 0 0 0 2 2 2
2 2 0 0 2 2 2 2 2 2 2 2 2 2 2 2 0 0 2 2
2 0 0 2 2 2 2 2 2 2 2 2 2 2 2 2 2 0 2 2
2 2 2 2 2 2 2 2 2 2 2 2 2 2 2 2 2 0 2 2
2 0 2 2 2 2 2 2 2 2 2 2 2 2 2 2 2 0 2 2
2 0 2 2 2 2 2 2 2 2 2 2 2 2 2 2 2 0 2 2
2 0 2 2 2 2 2 2 2 2 2 2 2 2 2 2 2 2 2 2
2 0 2 2 2 2 2 2 2 2 2 2 2 2 2 2 0 0 2 2
2 0 0 0 0 2 2 2 2 2 2 2 2 2 2 0 0 2 2 2
2 2 0 0 0 2 2 2 2 2 2 2 2 0 0 0 2 2 2 2
2 2 2 2 0 0 2 2 2 2 2 0 0 0 2 2 2 2 2 2
2 2 2 2 2 0 0 0 0 0 0 0 2 2 2 2 2 2 2 2
2 2 2 2 2 2 2 2 2 2 2 2 2 2 2 2 2 2 2 2